################
#.......@......#
#..............#
#.....####.....#
#..............#
#..##......##..#
#..#........#..#
#..............#
#..............#
#..#........#..#
#..##......##..#
#..............#
#.....####.....#
#..............#
#......@.......#
################