################
#@.....#.......#
#..............#
#..............#
#...###..####..#
##..#......#...#
#...#......#...#
#...#......#...#
#...#......#...#
#...#......#...#
#...#......#..##
#..####..###...#
#..............#
#..............#
#.......#.....@#
################