################
#......#.......#
#..............#
#..............#
#...###..####..#
##..#......#...#
#...#......#...#
#...#......#...#
#...#......#...#
#...#......#...#
#...#......#..##
#..####..###...#
#..............#
#..............#
#.......#......#
################